1111111111111111111111
1000000000000C00000001
1010101010101010101001
10C000X000000000000001
1010101010101010101001
1000000000C0X000000001
1010101010101010101001
100000C0000P0000000001
1010101010101010101001
1000000X00C00000000001
1010101010101010101001
10000000000000000C0001
1010101010101010101001
1000C0X000000000000001
1010101010101010101001
100000000000000C000001
1010101010101010101001
1000000C00000000000E01
1111111111111111111111
